111111111
100C00001
1E00000P1
100C00001
111111111