111111111
100C0C111
1P00C0ME1
100CM0001
111111111
