111111111
100C00001
1P00000E1
100C00CM1
111111111
